1111111111111111111111111111111111
1000000000000P00000000000000000001
101001010C1000001010010C0000010101
10100100100010100010010EE000010001
1000000000000000000000001000000001
1111111111111111111111111111111111