11111111111111111111111
10010000000000001000001
10C00111110011111001111
100P110E000000000000001
11111111111111111111111